#...##..#.#..............##.#..#..#.#....###.##...
.#.....##.......#..##.............#.#...#.........
.#..##..........#...#........#..#...##....#.#.....
.....#..........#....##..#....#..........#...#..#.
.###.#.........#..#.........#........#...#...#...#
#.......#..#...#..#.....#.#..#...#....##..#..#....
#####.#..##..#....#....####..#.....#...#......#..#
..##..#.........#.....#.....#...........###.......
.#.......#.....#...###.....#....#.#.#..#.......#.#
.#..#.##....#.##..#................#.#.#.....#....
#...#..#..#.#.###......#.......#....###......#..##
##..#..#......#...#.........#....#.##.#.#....#.##.
#..#.....#..#.......##.....#...#..#.............##
..#..#.#..#.#...##...#.##....#...#.#....####....##
.....####.#.....#.....#....#..#..........#.#...#..
#.#.###...#..#........#.##.#..##.......#.......##.
....#.#...##..........#...##...#.###.#...........#
.###.........##............#.......##..##.#...#..#
#...#....#...#.#..........#...##......##......##.#
..##...##.......#.......##..#......#...####.......
###..#...#....#..#...#.............#.......#.##.##
.#.#.##.#.#..#.....#.#........#....##.......###.#.
.#...##.###......###.#....#....#........#.##...#..
..###.##.....#.#..#.#.#........#.#......#...###...
.....#...##.###.#...#...#..#..#...#..#.##.....#...
..#.##.#####..##....#.##.##.......#........###.#..
#........#.#.#.............##.#...####....##.#....
...#..#..#.##.##.#....#.....###....##...#....#.#..
.##.#.##..##.##.##...#...#.....#...#....#.#.#..#..
....##.#.###.#.#..###..#.#.....#.#.......###.##.#.
#..###.....##...##.###.#....#.#.#.....##..##.#....
#..#..#.#.###..#...#...##.#..#....###.#........#.#
..#.#.#..##.#.....##.#.#.#...#.##..#.....###...##.
...#..#.##.....#.....#.#...#.#..#...###....##.#...
.###....######.##.....#####..#..#..#.....#....#..#
#....##..###..##.###...#...#..##.##...#.#..#....#.
##.....#.......#..###......#.##..#......##..#.#..#
.......#..##.#.#.#...##........#.#.#...##.###.##..
#......#...####.#..#....#..#.....#..##.#...#...#.#
####..#....##.....#......#.#.......#...##...#.##.#
........#..#.##..##...........#.....####.##...#...
#....#.##....##.........#.......###...##...#.#...#
..#.......#....#.####.##.......#.#.###...#####..#.
.#..##.#.#....##....##......#.....#.#..#.#.#...#..
#..#...#.....#...........#.#.##.....##....#.##...#
#....#...##....###.#..#.............#..#.....#.#..
....#.#...#.....#.##.........#.##.##....#.....#.##
........#......##....#..#..#.#....#.#.##..#......#
.#.#..#......#......#..##..#......#.##....##.....#
#.........#...#..#.##.#####.........#.....#..#....
