......#....#
...#........
....#.....#.
..#.........
.........#..
.#....#.....
...#........
#......#....
............
............
..........#.
..........#.
